30 30 30 30 30 30 30 30 30 30 30 30 30 30 30 30 30 30 30 30 30 30 30 30 30 30 30 30 30 30 30 30 30 30 30 30 30 30 30 30 30 30 30 30 30 30 30 30 30 30           
30 30 30 30 30 30 30 30 30 30 30 30 30 30 30 30 30 30 30 30 30 30 30 30 30 30 30 30 30 30 30 30 30 30 30 30 30 30 30 30 30 30 30 30 30 30 30 30 30 30
30 30 30 30 30 30 30 30 30 30 30 30 30 30 30 30 30 30 30 30 30 30 30 30 30 30 30 30 30 30 30 30 30 30 30 30 30 30 30 30 30 30 30 30 30 30 30 30 30 30
30 30 30 30 30 30 30 30 30 30 30 30 30 30 30 30 30 30 30 30 30 30 30 30 30 30 30 30 30 30 30 30 30 30 30 30 30 30 30 24 24 24 24 24 24 24 24 24 24 24
30 30 30 30 30 30 33 35 35 35 35 35 35 35 35 35 35 35 35 35 35 35 35 35 35 35 35 35 35 35 35 35 35 35 38 30 30 30 30 24 26 26 26 26 26 26 26 26 26 24
30 30 30 30 30 30 39 31 31 31 31 31 31 31 31 31 31 31 31 31 31 31 31 31 31 31 31 31 31 31 31 31 31 31 10 30 30 30 30 24 26 26 26 26 26 26 26 26 26 24
30 30 30 30 30 30 39 31 21 36 36 36 36 36 36 36 36 36 36 36 36 36 36 37 31 21 36 36 36 36 36 36 36 36 25 30 30 30 30 24 26 26 26 26 26 26 26 26 26 24
30 30 30 30 30 30 39 31 10 30 30 30 30 30 30 30 30 30 30 30 30 30 30 39 31 10 30 30 30 30 30 30 20 30 30 30 30 30 30 24 26 26 26 26 26 26 26 26 26 24
30 30 30 30 30 30 39 31 10 12 16 16 16 16 13 30 30 30 30 30 30 30 30 39 31 10 30 30 30 30 30 30 20 30 30 30 30 30 30 24 26 26 26 26 26 26 26 26 26 24
30 30 30 30 30 30 39 31 10 17 29 32 29 32 18 30 30 30 30 30 30 30 30 39 31 10 30 30 30 30 30 30 20 30 30 30 30 30 30 24 26 26 26 26 26 26 26 26 26 24
30 30 30 30 30 30 39 31 10 14 19 19 19 19 15 30 30 30 30 30 30 30 30 39 31 10 30 30 30 30 30 30 20 30 30 30 30 30 30 24 24 24 24 24 27 24 24 24 24 24
30 30 30 30 30 30 39 31 10 30 30 30 30 30 30 30 30 30 30 30 30 30 30 39 31 10 30 30 30 30 30 30 20 30 30 30 30 30 30 30 30 30 30 24 27 24 30 30 30 30
30 30 30 30 30 30 39 31 10 30 30 30 30 30 30 30 30 30 30 30 30 30 30 39 31 10 30 30 20 20 20 20 20 30 30 30 30 30 30 30 30 30 30 24 27 24 30 30 30 30
30 30 30 30 30 30 39 31 10 30 30 30 30 30 30 30 30 30 30 30 30 30 30 39 31 10 30 30 30 30 30 30 30 30 30 30 30 30 30 30 30 30 30 24 27 24 30 30 30 30
30 30 30 30 30 30 39 31 10 30 30 30 30 30 30 30 30 30 30 30 30 30 30 39 31 10 30 30 30 30 30 30 30 30 30 30 30 30 30 30 30 30 30 24 27 24 30 30 30 30
30 30 30 30 30 30 39 31 11 35 35 35 35 35 35 35 35 35 35 35 35 35 35 23 31 11 35 35 35 35 35 35 35 35 38 30 30 30 30 30 30 30 30 24 27 24 30 30 30 30
30 30 30 30 30 30 39 31 31 31 31 31 31 31 31 31 31 31 31 31 31 31 31 31 31 31 31 31 31 31 31 31 31 31 10 30 30 30 30 30 30 30 30 24 27 24 30 30 30 30
30 30 30 30 30 30 39 31 21 36 36 36 36 36 36 36 36 36 36 36 36 36 36 37 31 21 36 36 36 36 36 36 36 36 25 30 30 30 30 30 30 30 30 24 27 24 30 30 30 30
30 30 30 30 30 30 39 31 10 30 30 30 30 30 30 30 30 30 30 30 30 30 30 39 31 10 30 30 30 30 30 30 30 30 30 30 30 30 30 30 30 30 30 24 27 24 30 30 30 30
30 30 30 30 30 30 39 31 10 30 30 30 30 30 30 30 30 30 30 30 30 30 30 39 31 10 30 30 30 30 30 30 30 30 30 30 30 30 30 30 30 30 30 24 27 24 30 30 30 30
30 30 30 30 30 30 39 31 10 30 30 30 28 20 20 20 20 28 20 20 20 30 30 39 31 10 30 30 28 20 20 20 20 28 20 20 20 30 30 30 30 30 30 24 27 24 30 30 30 30
30 30 30 30 30 30 39 31 10 30 30 30 20 28 24 24 24 24 24 20 28 30 30 39 31 10 30 30 20 28 24 24 24 24 24 20 28 30 30 24 24 24 24 24 27 24 24 24 24 24
30 30 30 30 30 30 39 31 10 30 30 30 20 20 24 26 26 26 24 35 35 35 35 23 31 10 30 30 20 20 24 26 26 26 24 20 20 30 30 24 27 27 27 27 27 27 27 27 27 24
30 30 30 30 30 30 39 31 10 30 30 30 20 20 24 26 26 26 26 31 31 31 31 31 31 10 30 30 20 20 24 26 26 26 24 20 20 30 30 24 27 27 27 27 27 27 27 27 27 24
30 30 30 30 30 30 39 31 10 30 30 30 28 20 24 26 26 26 24 36 36 36 36 37 31 10 30 30 20 20 24 26 26 26 24 20 20 30 30 24 27 27 27 27 27 27 27 27 27 24
30 30 30 30 30 30 39 31 10 30 30 30 20 20 24 24 24 24 24 20 20 30 30 39 31 10 30 30 20 20 24 24 28 24 24 28 20 30 30 24 27 27 27 27 27 27 27 27 27 24
30 30 30 30 30 30 39 31 10 30 30 30 20 20 20 28 20 20 20 28 20 30 30 39 31 10 30 30 20 20 20 20 28 20 20 20 20 30 30 24 27 27 27 27 27 27 27 27 27 24
30 30 30 30 30 30 39 31 10 30 30 30 30 30 30 30 30 30 30 30 30 30 30 39 31 10 30 30 30 30 30 30 28 30 30 30 30 30 30 24 24 24 24 24 28 24 24 24 24 24
30 30 30 30 30 30 39 31 10 30 30 30 30 30 30 30 30 30 30 30 30 30 30 39 31 10 30 30 30 30 28 28 28 30 30 30 30 30 30 30 30 30 30 30 28 30 30 30 30 30
35 35 35 35 35 35 23 31 11 35 35 35 35 35 35 35 35 35 35 35 35 35 35 23 31 10 30 30 30 30 28 30 30 30 30 30 30 30 30 30 30 30 30 30 28 30 30 30 30 30
31 31 31 31 31 31 31 31 31 31 31 31 31 31 31 31 31 31 31 31 31 31 31 31 31 10 30 30 30 30 28 30 30 30 30 30 30 30 30 30 30 30 30 30 28 30 30 30 30 30
36 36 36 36 36 36 36 36 36 36 36 36 36 36 36 36 36 36 36 36 36 36 36 36 36 25 30 30 30 30 28 28 28 28 28 28 30 30 30 30 28 28 28 28 28 30 30 30 30 30
30 28 30 30 30 30 30 30 30 30 30 30 30 30 30 30 30 30 30 30 30 30 30 30 30 30 30 30 30 30 30 30 30 30 30 28 30 30 30 30 28 30 30 30 30 30 30 30 30 30
30 28 30 30 30 30 30 30 30 30 30 30 30 30 30 30 30 30 30 30 30 30 30 30 30 30 30 30 30 30 30 30 28 28 28 28 30 30 30 30 28 30 30 30 30 30 30 30 30 30
30 28 30 30 30 30 30 30 30 12 16 16 16 13 30 30 30 30 30 30 30 30 30 30 30 30 30 30 30 30 30 30 28 30 30 30 28 28 28 28 28 28 28 28 28 30 30 30 30 30
30 28 30 30 30 30 30 30 30 17 43 19 42 18 30 30 30 30 30 30 30 30 30 30 30 30 30 30 30 30 30 28 28 28 30 30 28 28 28 28 28 28 28 28 28 30 30 30 30 30
30 28 30 30 30 30 30 30 30 17 18 28 17 18 30 30 30 30 30 30 30 30 30 30 30 30 30 30 30 30 30 28 28 28 30 30 28 28 28 28 28 28 28 28 28 30 30 30 30 30
30 28 30 30 30 30 30 30 30 17 18 28 17 18 30 30 30 30 30 30 28 28 28 28 28 28 28 28 28 30 30 28 28 28 30 30 28 28 28 28 28 28 28 28 28 30 30 30 30 30
30 28 30 30 30 30 30 30 30 14 15 28 14 15 30 30 30 30 30 30 28 30 30 30 30 30 28 30 28 30 30 30 28 30 30 30 30 30 30 30 28 30 30 30 30 30 30 30 30 30
30 28 30 30 30 30 30 30 30 30 30 28 30 30 30 30 30 30 30 30 28 30 30 30 30 30 28 28 28 30 30 30 28 30 30 30 30 30 30 30 28 30 30 30 30 30 30 30 30 30
28 28 28 28 28 28 30 30 30 30 30 28 30 30 30 30 30 30 30 30 28 28 28 28 30 30 30 30 28 30 30 30 28 30 30 30 30 30 30 30 28 30 30 30 30 30 30 30 30 30
28 28 28 28 28 28 28 28 28 30 30 28 30 30 30 30 30 30 30 30 30 30 30 28 30 30 30 30 28 28 28 28 28 30 30 30 30 30 30 30 28 30 30 30 30 30 30 30 30 30
28 28 28 28 28 28 28 28 28 28 28 28 30 30 30 30 30 30 30 30 30 30 30 28 12 16 16 13 28 28 28 28 28 12 16 16 16 16 16 13 28 12 16 16 16 16 16 16 16 16
13 28 28 28 28 28 28 28 28 28 28 28 28 28 28 28 28 28 28 30 30 30 30 28 17 32 32 18 28 28 28 28 28 17 32 32 32 32 32 18 28 17 32 32 32 32 32 32 32 32
40 16 16 16 16 16 13 28 28 12 16 16 16 16 16 16 16 13 28 30 30 30 30 28 17 32 32 40 16 16 16 13 28 17 32 32 32 32 32 18 28 17 32 32 32 32 32 32 32 32
32 32 32 32 32 32 18 28 12 41 32 32 32 32 32 32 32 18 28 28 30 30 30 28 17 32 32 32 32 32 32 18 28 14 19 19 19 19 19 15 28 17 32 32 32 32 32 32 32 32
32 32 32 32 32 32 40 16 41 32 32 32 32 32 32 32 32 40 13 28 28 30 30 28 17 32 32 32 32 32 32 18 28 28 28 28 28 28 28 28 28 17 32 32 32 32 32 32 32 32
32 32 32 32 32 32 32 32 32 32 32 32 32 32 32 32 32 32 40 13 28 28 28 28 17 32 32 32 32 32 32 40 16 16 16 16 16 16 16 16 16 41 32 32 32 32 32 32 32 32
32 32 32 32 32 32 32 32 32 32 32 32 32 32 32 32 32 32 32 40 16 16 16 16 41 32 32 32 32 32 32 32 32 32 32 32 32 32 32 32 32 32 32 32 32 32 32 32 32 32
32 32 32 32 32 32 32 32 32 32 32 32 32 32 32 32 32 32 32 32 32 32 32 32 32 32 32 32 32 32 32 32 32 32 32 32 32 32 32 32 32 32 32 32 32 32 32 32 32 32
